##########
#@       #
# $  #   #
#    # . #
#        #
#  $ #   #
#    # . #
#        #
#        #
##########