##########
#@$      #
# #$#### #
#  .  .  #
# ###.## #
# $ . #  #
# # # #$ #
# #   #  #
#        #
##########