##########
#@       #
# #$# .  #
#  .     #
# ##$##  #
# #   #  #
# # $ #  #
# #####  #
# .      #
##########